NO ./images/brick-3.xpm
SO ./images/cement.xpm
WE ./images/marble.xpm
EA ./images/circle-red.xpm

F 232,200,93
C 0,222,174

        1111111111111111111111111
        1000000000000000000000001
        1000000000000000000000001
        10000000000000000000W0001
111111111011000001110000000000001
100000000011000001110111111111111
11110111111111011100000010001
11110111111111011101010010001
11000000110101011100000010001
10000000000000001100000010001
10000000000000001101010010001
1100000111010101111101111000111
11110111 1110101 101111010001
11111111 1111111 111111111111
